10 7
W W W W W W W
W L L W W W W
W L L W W W L
W W W W L W L
W W W W L W W
W W W W L L L
W W W W W W W
W L W L L L W
W L W L W L W
W L L L W W W
